# A part-of-speech dictionary that's used additionally to the binary dictionary (*.dict).
# This does not add words to the spell checker, see hunspell/spelling.txt for that.
# File Encoding: UTF-8
# Format: three tab-separated fields: fullform baseform postags
Eli	Eli	NPCSSP0
Gloucester	Gloucester	NPCSG00
Guayas	Guayas	NPMSG00
Laclau	Laclau	NPCNSP0
Leicester	Leicester	NPCSG00
MWC	MWC	NPMSO00
Scholz	Scholz	NPCNSP0
TC	TC	NCCN000
ecofeminismo	ecofeminismo	NCMS000
ecofeminista	ecofeminista	AQ0CS0
ecofeministas	ecofeminista	AQ0CP0
gigafactoría	gigafactoría	NCFS000
gigafactorías	gigafactoría	NCFP000
lacrosse	lacrosse	NCMS000
quiche	quiche	NCCS000
quiches	quiche	NCCP000
